Gen-0
1,28,516,0,35,0,0,0,0,0,80,0,576,640,10,0,546,580,0,0,0,165,0,225,616,10,0,0,0,0
2,2,5,545
Gen-1
1,12,180,576,0,580,0,10,65,96,515,611,581,640
2,18,5,546,545,616,576,0,0,635,611,0,260,101,165,515,65,0,515,60
Gen-2
1,9,580,576,611,581,225,741,10,580,570
2,21,611,546,616,576,65,640,130,610,160,581,65,616,96,645,810,545,131,576,721,545,485
Gen-3
1,12,580,611,581,741,721,580,645,839,610,515,360,516
2,18,616,640,645,485,840,840,546,721,370,720,10,641,610,840,720,720,35,96
Gen-4
1,14,741,611,721,645,839,100,261,720,1411,1226,576,546,840,581
2,16,840,516,840,721,720,810,645,0,896,720,351,721,720,841,841,721
Gen-5
1,15,741,611,1264,815,1271,1396,1293,839,1411,1226,840,210,96,896,0
2,15,840,840,586,841,841,841,840,841,485,840,896,720,841,840,817
Gen-6
1,16,1411,1264,1271,1396,1293,596,640,840,1400,1266,841,1491,841,636,225,641
2,14,841,840,1866,896,841,1826,841,640,1293,784,841,841,841,1303
Gen-7
1,15,1411,1396,1293,1400,641,4096,1350,835,645,1400,864,0,576,896,1839
2,15,896,640,391,1824,841,841,896,721,1293,1528,840,721,896,450,1159
Gen-8
1,16,740,709,591,1400,1839,515,841,841,841,741,515,1774,1411,943,821,3405
2,14,896,1159,1293,1528,1159,783,896,896,721,0,0,3904,721,720
Gen-9
1,15,1411,1400,1839,1774,3405,721,816,106,874,576,1839,1286,0,225,3520
2,15,1528,1824,1293,1159,3405,841,50,841,896,0,0,720,700,896,783
Gen-10
1,16,3405,1839,1774,1839,3520,1809,864,841,1293,260,260,571,710,1839,641,841
2,14,1528,1824,1293,1159,3520,825,0,819,841,350,0,0,100,65
Gen-11
1,17,3405,1839,1839,3063,1839,841,768,1419,0,831,641,576,841,596,1514,874,829
2,10,1528,1824,1293,1159,851,1827,820,841,721,60
3,3,896,841,810
Gen-12
1,14,3405,641,576,1414,836,1393,1293,3712,3904,1809,1839,1839,3063,1839
2,10,1528,721,887,841,721,841,840,1824,1159,1827
3,6,839,1293,841,810,0,840
Gen-13
1,16,3405,3712,3904,0,795,575,576,1281,820,836,641,1326,261,821,1839,3063
2,9,1528,887,1824,1824,841,1821,801,1159,1827
3,5,896,1819,841,810,840
Gen-14
1,14,3405,3712,3904,1839,841,841,841,896,4068,3698,1614,2767,580,3520
2,10,1528,1824,1824,1821,0,721,841,880,5,1827
3,6,896,880,831,841,810,840
Gen-15
1,12,3063,3712,3904,4068,3698,10,841,4073,3063,515,225,841
2,9,1528,1824,1824,1821,896,691,0,841,1827
3,5,585,880,1293,841,840
4,4,200,896,1540,576
Gen-16
1,11,3712,4068,3698,4073,841,4512,841,841,841,4096,841
2,8,1528,1824,1824,1821,1341,841,1824,1827
3,6,896,880,1293,555,841,840
4,6,200,3904,896,851,576,1282
Gen-17
1,12,3712,4068,4073,4512,4096,841,545,841,841,3063,4078,2230
2,7,1824,1824,1821,1824,1795,840,1827
3,5,896,880,851,841,840
4,5,3904,896,1540,576,1282
Gen-18
1,12,4068,4073,4512,4096,4078,1411,4096,896,0,3038,610,841
2,8,1824,1824,1821,1824,879,1822,1825,1827
3,5,2235,880,1293,841,840
4,6,3904,896,1540,576,1282,721
Gen-19
1,10,4512,4073,4078,4096,4083,1241,840,620,841,841
2,7,1824,1824,1824,1825,840,889,1827
3,6,851,880,1293,576,841,840
4,8,3904,896,1540,1282,4096,721,966,235
Gen-20
1,11,4512,4073,4078,4096,4083,841,4088,841,1470,841,640
2,6,1824,1824,1824,1825,841,1827
3,5,896,880,851,841,840
4,7,3904,1540,1282,4096,966,611,840
Gen-21
1,11,4512,4078,4096,4083,4088,4096,1495,4073,1823,841,841
2,7,1824,1824,1824,1825,1827,840,841
3,5,640,880,1293,841,840
4,8,3904,1540,1282,4096,966,841,841,791
Gen-22
1,13,4512,545,1531,1824,1321,841,946,545,4096,4083,4088,4096,3063
2,6,1824,1824,1824,1825,1827,661
3,5,896,880,851,841,840
4,7,3904,1540,1282,4096,966,576,841
Gen-23
1,11,4512,4066,0,1490,131,4096,1529,4096,4083,4088,4096
2,7,1824,0,1215,1824,1824,1825,1827
3,5,951,880,1293,841,840
4,8,3904,1231,840,1293,1540,1282,4096,966
Gen-24
1,12,4512,4096,4096,841,1479,841,3508,1500,1809,4096,4088,4096
2,6,1824,1824,841,1824,1825,1827
3,5,896,880,1539,841,840
4,7,3904,1293,226,645,1540,1282,4096
Gen-25
1,12,4512,4096,4096,640,4073,841,6015,841,590,1824,4096,4096
2,6,1824,1824,721,1824,1825,1827
3,5,896,880,1819,841,840
4,7,3904,1293,545,1551,1540,1282,4096
Gen-26
1,13,4512,4096,4096,6015,576,720,1406,1060,841,195,841,605,4096
2,5,1824,1824,1824,1825,1827
3,5,896,880,1834,841,840
4,8,3904,1293,1551,0,225,841,1540,4096
Gen-27
1,11,4512,4096,4096,6015,841,2592,841,2545,1499,841,4096
2,7,1824,1824,841,841,1824,1825,1827
3,5,896,880,610,841,840
4,7,3904,1293,1551,1411,106,1540,4096
Gen-28
1,12,4512,4096,4096,6015,4096,2473,65,896,840,35,841,4096
2,6,1824,1824,841,1824,1825,1827
3,5,851,880,1293,841,840
4,8,3904,1551,1411,1540,1409,1839,1293,4096
Gen-29
1,10,4512,4096,4096,6015,4096,841,841,841,841,261
2,7,1824,1824,1824,841,1826,1825,1827
3,5,896,880,851,841,840
4,8,3904,1551,1540,1839,4096,721,315,316
Gen-30
1,11,4512,4096,4096,6015,4096,4512,3053,4058,840,485,5
2,8,1824,1824,1826,665,1826,896,1825,1827
3,5,266,880,1293,841,840
4,7,3904,1551,1540,1839,4096,1091,601
Gen-31
1,11,4512,4096,4096,6015,4512,841,1514,35,1809,835,1530
2,7,1824,1826,1826,1825,721,2389,1827
3,5,896,880,5,841,840
4,8,3904,1551,1540,1839,4096,801,1838,545
Gen-32
1,11,4512,4096,4096,6015,4512,1525,0,3181,721,35,35
2,7,1827,1826,1826,1825,2389,5,1824
3,5,1535,880,1293,841,840
4,8,3904,1551,1839,4096,1838,821,841,841
Gen-33
1,10,4512,4096,4096,6015,4512,531,840,841,35,12000
2,6,1827,1826,1826,1825,2389,2514
3,5,40,880,1293,841,840
4,9,3904,1551,1839,4096,1838,3053,840,10,841
Gen-34
1,14,4512,0,0,0,1545,1345,4088,841,0,4096,6015,4512,12000,841
2,8,1827,0,1826,1826,2389,2514,65,0
4,8,3904,1839,11800,1838,3053,791,821,721
Gen-35
1,13,4512,645,260,1825,704,4096,60,2530,841,545,6015,4512,12000
2,7,1827,1817,896,1826,1826,2389,0
4,10,3904,841,140,791,841,836,1839,4096,1838,3053
Gen-36
1,14,4512,4096,801,4073,6015,261,841,841,1854,1640,841,515,4512,12000
2,8,1827,1817,60,1826,841,1826,1826,846
4,9,3904,640,260,840,661,1839,4096,1838,3053
Gen-37
1,14,4512,4096,6015,896,841,841,1519,1559,841,1293,2737,35,4512,12000
2,7,520,1817,1826,1875,691,1826,1826
4,9,3904,841,841,721,896,1839,4096,1838,3053
Gen-38
1,13,4512,4096,6015,4096,1614,545,1529,3063,0,100,4885,4512,12000
2,6,40,1817,1826,896,1826,1826
4,10,3904,0,595,841,0,1839,201,4096,1838,3053
Gen-39
1,15,4512,6015,4885,841,1460,195,0,640,1271,4512,1534,4512,841,0,12000
2,7,4895,1817,896,1103,1826,841,1826
4,9,3904,1839,4096,705,841,896,540,1838,3053
Gen-40
1,14,4512,6015,4885,4512,0,841,1513,5245,545,4073,841,580,2484,12000
2,8,0,1817,1103,1826,1826,5,1508,896
4,8,3904,1839,4096,610,485,721,1838,3053
Gen-41
1,15,4512,6015,4885,5245,1838,641,841,841,5237,2780,841,4320,65,4263,12000
2,7,1103,1817,2494,1826,1508,1825,841
4,9,3904,1839,4096,1838,315,106,325,3063,3053
Gen-42
1,15,4885,3068,1796,4320,6015,5245,5237,1400,12000,2500,596,1540,3063,2595,1529
2,6,1508,1817,4273,1826,1825,1826
4,9,3904,1839,4096,3063,3053,610,3063,841,650
Gen-43
1,14,4885,0,841,640,3904,545,841,840,1470,1535,6015,5245,5237,12000
2,7,4320,1827,896,1817,1826,1825,1826
4,8,3904,4096,841,841,4096,3063,3053,3520
Gen-44
1,13,4885,5245,2484,841,3063,1774,0,545,841,6015,5245,5237,12000
2,8,1540,1827,896,182,1821,1826,1825,1826
4,9,3904,4096,841,2740,546,768,4096,3520,3520
Gen-45
1,14,6015,5245,1710,35,1479,834,720,1760,1824,260,1509,5245,5237,12000
2,7,1826,851,1821,896,841,1825,1826
4,10,3904,4096,1901,841,640,3063,4096,4096,3063,3520
Gen-46
1,13,6015,5245,3038,640,576,35,0,3904,4096,720,5245,5237,12000
2,6,1509,1821,896,841,1825,1826
4,3,3904,4096,4096
5,8,606,841,841,576,1293,0,4096,3063
Gen-47
1,12,6015,5245,5075,1540,4268,55,0,709,5,5245,5237,12000
2,5,1826,1821,896,1825,1826
4,1,3904
5,12,4096,4096,841,841,1293,3063,730,841,841,65,3520,3063
Gen-48
1,11,6015,5245,3053,1245,4283,35,3058,0,5245,5237,12000
2,5,3520,1821,896,1825,1826
4,6,3904,841,640,546,841,896
5,9,4096,4096,3063,3520,3063,1794,0,841,3520
Gen-49
1,12,6015,5245,5245,841,4263,3053,540,3053,1765,515,5237,12000
2,6,1826,1821,896,841,1825,1826
4,5,896,841,640,841,896
5,8,4096,4096,3063,3520,2539,296,102,3063
Gen-50
1,12,6015,5245,5245,260,4273,2530,640,5198,165,5237,4096,12000
2,5,1826,1821,896,1825,1826
4,5,515,841,640,841,896
5,8,4096,4096,3063,3520,1271,3063,0,3520
Gen-51
1,12,6015,5245,545,5245,841,5237,4270,841,706,4037,841,12000
2,5,1826,1821,896,1825,1826
4,5,3904,841,640,841,4096
5,8,4096,4096,3063,3058,841,3520,1445,3520
Gen-52
1,11,6015,841,546,841,841,5245,5245,12000,5237,75,0
2,5,550,1821,896,1825,1826
4,6,3904,841,640,841,896,635
5,9,4096,4096,3063,3520,3063,721,841,841,1291
Gen-53
1,12,6015,4261,849,2536,806,1525,836,545,5245,5245,5237,12000
2,5,1826,1821,896,1825,1826
4,5,851,841,640,841,896
5,8,4096,4320,580,1529,4096,3063,3520,3520
Gen-54
1,12,6015,1490,35,450,841,260,610,5245,1824,5245,5237,12000
2,5,1826,1821,896,1825,1826
4,5,3904,841,640,841,545
5,8,4096,4320,1504,12400,3053,4096,3520,3520
Gen-55
1,11,6015,5245,0,1529,841,1599,1261,840,5245,5237,12000
2,5,1826,1821,896,1825,1826
4,5,1834,841,640,841,896
5,10,4096,4320,5185,165,801,771,791,640,4096,3520
Gen-56
1,11,6015,5245,1251,841,35,896,841,801,5245,5237,12000
2,6,1826,1821,896,1827,1825,1826
4,5,640,841,640,841,896
5,8,4096,4320,12400,1901,2365,4096,1921,3520
Gen-57
1,10,6015,5245,840,831,4512,1276,0,5245,5237,12000
2,5,1826,1821,1827,1825,1826
4,5,3904,841,640,841,806
5,10,4096,4320,5185,4096,515,190,956,841,4512,3520
Gen-58
1,12,6015,5245,5,1271,545,841,571,841,896,5245,5237,12000
4,6,4512,611,841,640,841,896
5,11,4096,4320,5185,4096,5920,801,3058,704,3520,0,4096
Gen-59
1,13,6015,5245,1540,721,1505,0,35,841,3048,580,5245,5237,12000
4,5,896,841,640,841,896
5,12,4096,4320,12400,4096,5920,721,580,841,841,1231,1090,791
Gen-60
1,13,6015,5245,5245,261,545,35,721,815,545,841,840,5237,12000
4,5,801,841,640,841,896
5,12,4096,4320,12400,4096,4512,581,841,225,545,841,226,195
Gen-61
1,13,6015,5245,5245,3063,840,841,0,5237,1538,1749,1493,2295,12000
4,5,3904,841,640,841,850
5,12,4096,4320,5185,4096,5920,515,840,225,1511,1511,576,841
Gen-62
1,16,6015,641,1520,1529,1825,1463,1529,5245,5245,5237,12000,260,35,60,3399,859
5,14,4096,4320,5185,4096,2300,3068,335,0,0,3395,3520,55,545,0
Gen-63
1,17,6015,485,841,841,195,35,1696,841,840,195,5245,1256,580,1293,5245,5237,12000
5,13,4096,4320,841,226,2526,841,1901,841,5883,841,1539,4096,3520
Gen-64
1,16,6015,5245,841,641,1824,4096,480,0,0,841,841,35,0,5245,5237,12000
5,14,4096,4320,1303,545,546,1061,841,3712,35,0,801,80,4096,3058
Gen-65
1,17,6015,5245,841,841,4883,1341,841,841,545,4258,841,515,841,841,5245,5237,12000
5,13,4096,5,3712,4096,4320,2372,841,640,1060,0,836,546,3058
Gen-66
1,18,6015,5245,1817,570,841,1505,545,831,841,1530,0,450,841,841,720,5245,5237,12000
5,12,4096,3712,4096,846,841,1386,896,721,165,1480,1216,3058
Gen-67
1,17,6015,5245,5245,10,565,826,12400,1524,640,721,841,0,705,841,610,5237,12000
5,13,730,3712,4096,1480,3712,841,3521,205,840,900,10,5,3520
Gen-68
1,18,6015,841,5245,840,5245,12400,0,1540,841,515,545,835,841,12000,35,645,1720,2529
5,12,3712,615,3712,3521,12600,1409,841,4261,576,576,581,3058
Gen-69
1,16,6015,35,515,1403,841,1715,840,720,3520,4071,5245,5245,846,12000,0,5
5,14,3712,841,841,1293,4093,841,1525,1098,841,225,3712,3521,12600,4261
Gen-70
1,15,6015,4071,6030,576,5123,841,1825,12400,5245,1519,0,4283,841,5245,230
5,15,3712,4093,1409,101,1293,1534,12400,1534,803,0,0,841,3712,12600,4261
Gen-71
1,16,6015,6030,12400,5245,4060,35,3715,3884,4483,1529,0,721,545,1903,1530,5245
5,14,3712,4093,12200,841,2757,804,2767,5,841,4096,1293,4096,851,4261
Gen-72
1,17,6015,6030,12400,5245,1509,709,841,4320,836,0,1499,261,841,840,1256,841,5245
5,13,4261,4093,1535,4096,4096,1241,841,0,0,100,0,0,0
Gen-73
1,18,6015,6030,12400,5245,841,3904,1530,4096,0,841,1485,35,841,5245,3904,35,0,1271
5,12,846,4093,12400,4096,4096,0,0,0,1839,4096,0,0
Gen-74
1,17,6015,6030,12400,5245,5245,721,515,0,841,841,0,545,840,1585,0,35,35
5,13,4093,1281,4096,4096,4096,580,101,4096,1783,5953,581,4089,0
Gen-75
1,16,6015,0,6030,40,5245,5245,1529,65,755,2235,1341,0,1399,515,750,641
5,14,4096,0,0,1256,841,835,0,155,896,1414,4096,4096,4096,5953
Gen-76
1,15,6015,6030,0,5195,515,5245,515,965,35,4258,841,849,1475,5245,2235
5,15,4096,0,841,1263,1353,841,1519,1464,1539,515,0,4096,4096,4096,1424
Gen-77
1,16,6015,6030,12400,5245,3028,1061,841,1795,4258,1273,586,1525,841,545,815,5245
5,14,1480,1539,841,4073,1579,0,3520,101,3334,1568,0,4096,4096,4096
Gen-78
1,17,6015,6030,5195,5245,840,5915,841,35,5921,841,225,12200,1615,641,0,841,5245
5,13,4096,4073,3520,825,0,0,1293,0,841,841,1293,1534,4096
Gen-79
1,18,6015,6030,5915,5921,12200,641,1900,1509,0,2738,841,1293,841,1530,4093,641,2783,4083
5,12,851,4073,3520,1534,3176,1293,0,580,0,4096,841,4096
Gen-80
1,19,6015,6030,5915,5921,12200,4320,1820,515,2535,641,841,1525,721,0,1215,0,1530,864,65
5,11,3520,4073,3520,4093,4096,566,841,3428,1320,0,841
Gen-81
1,18,6015,545,896,6030,5915,5921,12200,841,841,2739,4073,2530,1820,840,3329,1509,1305,3360
5,12,3520,4073,3520,4096,70,969,1216,2484,100,3098,1060,2629
Gen-82
1,19,6015,1540,1293,1405,1529,2215,841,100,1529,0,841,6030,815,370,1200,4203,5915,5921,12200
5,11,3176,841,962,0,841,0,1409,4073,3520,896,3098
Gen-83
1,18,6015,6030,641,896,1520,4096,0,0,4263,3304,12000,1500,4080,896,841,5915,5921,12200
5,12,3520,1409,896,65,365,1470,1839,580,3056,4208,3520,3098
Gen-84
1,19,6015,6030,12000,1293,0,2530,1539,1493,10,1293,2753,35,835,705,0,841,1539,5921,12200
5,11,3176,3056,851,3520,841,841,0,4096,1293,1355,3098
Gen-85
1,18,6015,6030,12000,5921,12200,1384,841,3520,0,65,4276,3059,1824,1529,841,3271,0,546
5,12,3520,3056,3520,1549,841,0,1293,0,1784,841,841,3098
Gen-86
1,19,6015,6030,12000,5921,12200,863,0,841,2628,0,2115,1219,546,545,841,1510,2125,0,2611
5,11,551,3056,3520,1784,841,1454,841,898,1524,0,3098
Gen-87
1,20,6015,6030,12000,5921,12000,1535,1670,841,641,841,1438,641,641,768,841,0,0,1535,864,2530
5,10,3098,3056,2611,1784,1524,1509,841,841,841,841
Gen-88
1,19,6015,3712,841,165,0,3514,0,35,1604,4096,640,2768,841,4320,2755,6030,12000,5921,12200
5,11,874,3056,3520,1784,1524,96,4521,0,4096,195,721
Gen-89
1,20,6015,6030,1535,841,1293,581,1350,841,841,641,515,841,515,641,35,4512,12000,1534,5921,12200
5,3,4096,0,1739
6,7,5,720,1519,3056,3520,1784,2760
Gen-90
1,16,6015,6030,12000,3712,4096,2796,933,841,841,841,65,1529,0,2530,5921,12200
5,4,4096,0,1875,1670
6,10,4521,1739,1519,3056,1539,20,0,4517,0,1784
Gen-91
1,15,6015,6030,12000,4070,1509,1815,841,0,5921,5280,841,12200,0,768,0
5,6,4096,0,1875,1670,722,841
6,9,2535,1739,3056,4517,1520,841,5252,0,1784
Gen-92
1,19,6015,6030,12000,5921,12200,841,165,4271,3500,1510,4276,5254,0,1534,841,641,545,485,1073
6,11,4521,3056,4517,5,1784,2155,739,1404,515,0,1444
Gen-93
1,20,6015,6030,12000,5921,12200,0,0,1535,841,896,1268,5982,4276,0,1519,0,925,100,5212,641
6,10,1083,3056,4517,1784,2155,713,1730,721,1411,866
Gen-94
1,19,6015,6030,12000,12200,2737,641,841,641,1293,35,1634,12400,5,1529,5199,5730,0,35,1818
6,11,3056,646,1784,2155,1730,3512,841,5183,1293,1839,545
Gen-95
1,20,6015,0,0,5898,1619,0,1540,3063,1529,1220,1519,641,3379,5195,0,6030,841,12000,12200,12400
6,10,3056,841,865,0,2510,2155,3512,1828,1839,5
Gen-96
1,21,6015,6030,0,841,1529,1529,1275,515,545,0,641,841,1518,545,12000,841,2485,2529,3712,12200,12400
6,9,3056,2510,580,841,4085,515,2155,851,1839
Gen-97
1,20,6015,6030,12000,1469,3712,0,1515,10,1293,641,955,1534,1534,5920,709,841,1525,10,12200,12400
6,10,3056,2510,3712,841,1544,1537,1819,841,2155,1839
Gen-98
1,19,6015,6030,12000,12200,874,641,841,35,0,5,545,4096,841,1525,0,4512,1398,1534,12400
6,11,3056,2510,15,841,841,0,0,3885,841,2155,1839
Gen-99
1,20,6015,6030,12000,12200,841,65,3847,0,841,720,1465,3103,1530,65,0,1524,1394,1268,545,12400
6,10,3056,2510,1539,2155,130,1765,0,0,0,1839
Gen-100
1,21,6015,6030,12000,12200,641,450,841,0,1535,0,841,4320,1635,1534,1650,3093,570,641,1518,12400,131
6,9,550,2510,2155,1765,0,0,841,0,1839
